OOOOOOOO.OO..
O O    . OOO.
O O OO   ....
O O O   XO.O.
O OOOO OOO...
O O O    O.O.
O OO...OOO.U.
O O      OO..
O O OO.OOOO..
O O O    .O..
OOOOOO.OO. ..
OOOOOOOOOOO..
OOOOOOOOOOO..